[country]
AE - United Arab Emirates (아랍에미리트)
AR - Argentina (아르헨티나)
AT - Austria (오스트리아)
AU - Australia (호주)
BE - Belgium (벨기에)
BG - Bulgaria (불가리아)
CR - Costa Rica (코스타리카)
CA - Canada (캐나다)
CH - Switzerland (스위스)
CO - Colombia (콜롬비아)
CU - Cuba (쿠바)
CZ - Czech Republic (체코)
DE - Germany (독일)
EG - Egypt (이집트)
EN - England (영국)
ES - Spain (스페인)
FR - France (프랑스)
GB - Great Britain (영국)
GR - Greece (그리스)
HK - Hong Kong (홍콩)
HU - Hungary (헝가리)
ID - Indonesia (인도네시아)
IE - Ireland (아일랜드)
IN - India (인도)
IS - Iceland (아이슬란드)
IT - Italy (이탈리아)
JP - Japan (일본)
KR - South Korea (대한민국)
LT - Lithuania (리투아니아)
LV - Latvia (라트비아)
MA - Morocco (모로코)
MX - Mexico (멕시코)
MY - Malaysia (말레이시아)
NG - Nigeria (나이지리아)
NL - Netherlands (네덜란드)
NP - Nepal (네팔)
NZ - New Zealand (뉴질랜드)
PE - Peru (페루)
PH - Philippines (필리핀)
PK - Pakistan (파키스탄)
PL - Poland (폴란드)
PT - Portugal (포르투갈)
RO - Romania (루마니아)
RS - Serbia (세르비아)
RU - Russia (러시아)
SA - Saudi Arabia (사우디아라비아)
SE - Sweden (스웨덴)
SG - Singapore (싱가포르)
SI - Slovenia (슬로베니아)
SK - Slovakia (슬로바키아)
TH - Thailand (태국)
TR - Turkey (터키)
TT - Trinidad and Tobago (트리니다드토바고)
TW - Taiwan (대만)
UA - Ukraine (우크라이나)
UK - United Kingdom (영국)
US - United States (미국)
VE - Venezuela (베네수엘라)
ZA - South Africa (남아프리카 공화국)
ZH - China (중국)
이 목록을 참고하여 각 코드에 맞는 국가 이름을 사용할 수 있습니다.
